NO ./textures/rb.xpm
SO ./textures/rb2.xpm
WE ./textures/gb.xpm
EA ./textures/gb2.xpm
C 255,192,203
F 255,192,203
1111111111111111111111111
1000000000110000000000001
1011000001110000000000001
100100000000000000000000111111111
 1111111101100000111000000000000111
        100000000011000001110111100111111
        11110111111111011100000010001
        11110111111111011101111000001
        110000001101010111001 1010001
        10000000000000001100111010001
        10000000000000001101010010001
        11000001110101011111011110E0111
        11110111 1110101 101111010001
        11111111 1111111 111111111111