NO ./textures/bricks.xpm
SO ./textures/bookshelf.xpm
WE ./textures/ore.xpm
EA ./textures/furnace.xpm

C 141,223,224
F 13,61,6

1111111111111111
10000001000030001
1000000100000001
1100110000111011
1000000100000001
10000001000N0001
1111111111111111