111111
1P0001
110001
1E10C1
111111