11111111
100100C1
1E110C11
1C010C11
11P0C011
11111111
