11111111
1E0100C1
10110C11
1C010C11
11PPC011
11111111